,full,ENTRIES_x,EXITS                                                               _x,change_x,ENTRIES_y,EXITS                                                               _y,change_y,diff,pct
0,1 AV BMT,17880082.0,27890667.0,92731,18153942061,18297777449,48610,-44121,-47.57955807658712
1,103 ST IND,1273297291.0,1088749033.0,27999,1262482086,1071224467,8338,-19661,-70.22036501303617
2,103 ST IRT,4228302521.0,3706815453.0,150382,4104351709,3674078928,51010,-99372,-66.07971698740542
3,103 ST-CORONA IRT,3130582269.0,3095738354.0,126895,2635167208,2694427080,61451,-65444,-51.57334804365814
4,104 ST BMT,12070979.0,6243102.0,15522,24017334,13993563,14080,-1442,-9.290039943306274
5,104 ST IND,373160993.0,404318860.0,9095,303384027,302570444,3818,-5277,-58.02089059923035
6,110 ST IRT,1655207228.0,1579552450.0,64573,1699722681,1638643426,24523,-40050,-62.022826878106954
7,111 ST BMT,740357312.0,644282259.0,13658,732357946,638538469,5790,-7868,-57.607263142480605
8,111 ST IND,657667080.0,216176260.0,15095,426011375,145136913,6010,-9085,-60.18549188473005
9,111 ST IRT,2268940986.0,1381113653.0,105939,2337095745,1429632242,36385,-69554,-65.65476359036803
10,116 ST IND,14932476274.0,16099336782.0,44864,7421469755,8493645730,14931,-29933,-66.71941868758915
11,116 ST IRT,2565824450.0,949028325.0,155519,2624935124,1042633310,54095,-101424,-65.21646872729377
12,116 ST-COLUMBIA IRT,49819095727.0,10614606935.0,90534,49906764335,10670315151,13916,-76618,-84.62897916804735
13,121 ST BMT,76281846308.0,20560975144.0,13323,76289060269,20568058421,6433,-6890,-51.71507918636944
14,125 ST IND,20733435349.0,17264008369.0,178627,4592111427,3980348008,59063,-119564,-66.93500982494248
15,125 ST IRT,159221623757.0,107953645329.0,280757,159385252942,108144178504,89969,-190788,-67.9548506359592
16,135 ST IND,3706479489.0,1292131945.0,35328,3118083209,997710189,8890,-26438,-74.83582427536231
17,135 ST IRT,2041219331.0,762442527.0,85708,76168956534,71071409073,24599,-61109,-71.29906193120829
18,137 ST CITY COL IRT,2653351447.0,1368549980.0,88883,2685714603,1459351641,29508,-59375,-66.80130058616383
19,138/GRAND CONC IRT,41014507984.0,39593702304.0,12327,41027722440,39608895845,9299,-3028,-24.563965279467833
20,14 ST IND,3154443134.0,3553932700.0,226273,2158714121,2100349177,43047,-183226,-80.97563562599161
21,14 ST IRT,11865933519.0,3821383089.0,124069,11899622096,3855991239,28570,-95499,-76.97249111381569
22,14 ST-UNION SQ BMT,8244752095.0,4459545397.0,375315,8208501180,4509856775,84886,-290429,-77.38273183858891
23,14 ST-UNION SQ IRT,3276296561.0,3352503579.0,183645,3368829122,3468253218,49484,-134161,-73.05453456396853
24,145 ST IND,4917756897.0,5002802115.0,151783,4986839683,5089251103,47244,-104539,-68.87398457007701
25,145 ST IRT,21555229885.0,47586921949.0,63228,6053450028,14381200125,24124,-39104,-61.84601758714493
26,149/GRAND CONC IRT,597677776.0,106619114.0,81946,419807155,154576346,27632,-54314,-66.28023332438435
27,14TH STREET PTH,54873724.0,47494051.0,62082,46921533,65142986,27039,-35043,-56.44631294094907
28,15 ST-PROSPECT IND,5505565563.0,343508133.0,42069,4965076323,332545849,9010,-33059,-78.58280444032422
29,155 ST IND,1609728991.0,1181524167.0,41592,983392193,838371033,14696,-26896,-64.66628197730333
30,157 ST IRT,369482951.0,545654163.0,47719,362191463,533878348,18816,-28903,-60.569165321989146
31,161/YANKEE STAD IND,51795239971.0,80796539602.0,75289,115048989737,144035887994,27015,-48274,-64.11826428827584
32,161/YANKEE STAD IRT,70753953340.0,42243307884.0,49613,70674913674,42228953022,21730,-27883,-56.20099570677041
33,163 ST-AMSTERDM IND,833029220.0,469998715.0,29370,436274738,324464089,9359,-20011,-68.13415049370106
34,167 ST IND,73825668127.0,35493038041.0,52055,66648225454,32043602722,14907,-37148,-71.36298146191528
35,167 ST IRT,880770567.0,663411930.0,52484,927143239,723536523,26238,-26246,-50.00762137032238
36,168 ST IND,3107315086.0,471606388.0,78915,2996717128,400304245,27507,-51408,-65.14350883862383
37,168 ST IRT,149186403.0,623722711.0,65192,234244803,872837885,29525,-35667,-54.710700699472326
38,169 ST IND,1277802934.0,860517800.0,50229,1254073216,870239432,17814,-32415,-64.5344323000657
39,170 ST IND,14096829822.0,10662380646.0,41976,11831751921,8877253766,16653,-25323,-60.327329902801594
40,170 ST IRT,2354822377.0,2257414662.0,50690,2436219014,2342875439,20670,-30020,-59.222726376011046
41,174 ST IRT,236848714.0,613179765.0,31665,240221677,593270745,13560,-18105,-57.17669351018475
42,174-175 STS IND,602246032.0,287593576.0,31097,546215338,269700153,12537,-18560,-59.68421391130977
43,175 ST IND,15528153340.0,12662155823.0,84580,14448587039,11151077843,27755,-56825,-67.18491369117994
44,176 ST IRT,15038772224.0,11402600378.0,34222,609770321,412237267,14383,-19839,-57.97148033428788
45,18 AV BMT,82346020581.0,54053585293.0,67729,77865670743,51324434560,28485,-39244,-57.94268334096178
46,18 AV IND,1039364716.0,748792716.0,24883,613342427,516310626,8393,-16490,-66.27014427520798
47,18 ST IRT,5141217029.0,493454297.0,48028,4447231049,375600043,8980,-39048,-81.30257349879237
48,181 ST IND,2293531122.0,1909931553.0,71580,2628735599,2233583393,22281,-49299,-68.87259010896899
49,182-183 STS IND,641257999.0,293863198.0,20673,648846553,301517692,6799,-13874,-67.11169157838727
50,183 ST IRT,188835701395.0,113064774772.0,32933,188867302121,113087917546,16453,-16480,-50.04099231773601
51,190 ST IND,501181059.0,102160617.0,19321,503333824,102229584,3217,-16104,-83.34972309921847
52,191 ST IRT,180694647.0,220470241.0,7793,18154295547,40340963052,16102,8309,106.6213268317721
53,2 AV IND,5505208601.0,3915691735.0,106909,3324708020,3198496198,22387,-84522,-79.05976110523903
54,20 AV BMT,1299295462.0,840204686.0,56561,1023530106,710203143,19446,-37115,-65.619419741518
55,207 ST IRT,6159212558.0,208233043.0,30487,6280077024,243513321,13337,-17150,-56.25348509200643
56,21 ST IND,187456681.0,189148101.0,10663,193249895,196442087,4000,-6663,-62.487104942323924
57,21 ST-QNSBRIDGE IND,1890453022.0,1625492602.0,65980,1950870069,1687282773,21675,-44305,-67.14913610184905
58,215 ST IRT,223938007.0,6979051326.0,10007,224898472,6981890287,3396,-6611,-66.06375537124013
59,219 ST IRT,38484212769.0,13675689428.0,19947,37568614760,13352170900,7475,-12472,-62.5256930866797
60,225 ST IRT,80441676005.0,27333524002.0,24453,78497657337,26675456257,9558,-14895,-60.91277143908723
61,23 ST BMT,6380068296.0,1544379733.0,134904,5876736431,1443675884,22819,-112085,-83.08500859870723
62,23 ST IND,65615440264.0,83967278791.0,296969,66986763808,85721426110,64273,-232696,-78.35700022561277
63,23 ST IRT,83601229549.0,63869048086.0,263272,83432281679,63797248019,50189,-213083,-80.93644595703303
64,231 ST IRT,2065069071.0,90658756.0,63460,2102359078,96751474,22906,-40554,-63.904821935077216
65,233 ST IRT,4168776856.0,268147256.0,29670,4187929219,275601917,12941,-16729,-56.383552409841585
66,238 ST IRT,999947538.0,47045867.0,23957,988377071,47826732,8648,-15309,-63.901991067328964
67,25 AV BMT,441483369.0,121775323.0,30798,425271793,119349787,8454,-22344,-72.55016559516851
68,25 ST BMT,787209985.0,878990074.0,22145,884355858,864960800,9083,-13062,-58.9839692932942
69,28 ST BMT,1504359269.0,1996442832.0,74877,1486962347,1929410317,14361,-60516,-80.82054569493971
70,28 ST IRT,22270135934.0,28153998639.0,199827,2707774365,2891999935,44413,-155414,-77.77427474765672
71,3 AV 138 ST IRT,574059907.0,323242169.0,40201,607367131,347005259,15546,-24655,-61.329320166165026
72,3 AV BMT,792698582.0,927247819.0,36706,1082038182,1139777066,11396,-25310,-68.95330463684411
73,3 AV-149 ST IRT,91039754597.0,67791017421.0,128797,93697363680,70875359333,51423,-77374,-60.0743806144553
74,30 AV BMT,1313838589.0,1737074326.0,88383,1365317911,1791164624,27112,-61271,-69.3244175916183
75,33 ST IRT,15606098680.0,7224619260.0,151641,11678419495,5015038085,42020,-109621,-72.28981607876499
76,33 ST-RAWSON ST IRT,1614744420.0,1539789585.0,54412,1596267076,1533014850,12868,-41544,-76.35080496949203
77,34 ST-HERALD SQ BMT,9140645276.0,5912715120.0,257628,8792126613,5881094780,63720,-193908,-75.26666356141412
78,34 ST-HERALD SQ IND,60470536607.0,59213054159.0,390261,49644128349,48157728653,93477,-296784,-76.04756816591973
79,34 ST-HUDSON YD IRT,725256096.0,690827313.0,117553,614310602,607748856,22938,-94615,-80.48709943599907
80,34 ST-PENN STA IND,59476060107.0,64724932097.0,458980,58730540417,64829113404,101405,-357575,-77.90644472526036
81,34 ST-PENN STA IRT,126033239992.0,99460445286.0,449157,111830742096,88662125821,101924,-347233,-77.30771200270729
82,36 AV BMT,1477481111.0,1385842087.0,40658,1490142923,1396883660,13252,-27406,-67.40616852771902
83,36 ST BMT,2156737308.0,1313477700.0,85302,1930443302,1010023965,35629,-49673,-58.231928911397155
84,36 ST IND,4336256501.0,197937944.0,26559,3783137676,181968389,6877,-19682,-74.10670582476749
85,39 AV BMT,355163258.0,318117111.0,19058,356338242,322138549,6038,-13020,-68.31776681708469
86,4 AV-9 ST IND,1133291556.0,1185350872.0,23472,1174256597,1233597234,7426,-16046,-68.36230402181323
87,40 ST LOWERY ST IRT,2946043578.0,1846699031.0,61545,2500795336,1588086222,19105,-42440,-68.95767324721749
88,42 ST-BRYANT PK IND,88987166061.0,61402181783.0,239734,86644531645,59959344512,44387,-195347,-81.48489575946675
89,42 ST-PORT AUTH IND,220661099397.0,171578015054.0,530157,209012598674,161843519446,123630,-406527,-76.68049275969194
90,45 ST BMT,555377350.0,457547331.0,46911,595732924,493489458,19114,-27797,-59.25475901174565
91,46 ST BLISS ST IRT,2589683159.0,1586216677.0,78966,2721334196,1691604613,29009,-49957,-63.26393637768153
92,46 ST IND,739221898.0,919096068.0,50550,700256496,873112020,16782,-33768,-66.80118694362018
93,47-50 STS ROCK IND,128138034618.0,87065659933.0,336798,84471558996,88407980671,67860,-268938,-79.85142429586874
94,49 ST BMT,3522767681.0,3343610743.0,127439,3813856190,3922863559,20002,-107437,-84.30464771380818
95,4AV-9 ST BMT,1332970224.0,780633199.0,56859,9750964423,809580318,16146,-40713,-71.60344008864033
96,5 AV/53 ST IND,3810611175.0,4255439024.0,144367,3479731134,3887269676,22724,-121643,-84.25956070293073
97,5 AV/59 ST BMT,6931208546.0,1894108572.0,83226,5071280002,1314357796,23639,-59587,-71.59661644197726
98,5 AVE IRT,5894496975.0,385161185.0,85746,5919208729,413400191,15389,-70357,-82.05280712802929
99,50 ST BMT,536840012.0,517160272.0,20284,555119038,536045852,9600,-10684,-52.67205679353185
100,50 ST IND,15306671517.0,14428258627.0,118770,15875006716,14861640509,19210,-99560,-83.82588195672308
101,50 ST IRT,3471350104.0,3712072344.0,144011,2473906802,2946860405,18738,-125273,-86.98849393449112
102,51 ST IRT,27695108731.0,28727942562.0,114356,26493279070,27487414390,19353,-95003,-83.07653293224668
103,52 ST IRT,996865501.0,990324241.0,39404,956105909,949813728,22348,-17056,-43.28494569079282
104,53 ST BMT,5092232168.0,6153997430.0,57068,5233726185,6319251132,24239,-32829,-57.52610920305601
105,55 ST BMT,536996897.0,383492187.0,12587,545585372,386521398,6202,-6385,-50.726940494160644
106,57 ST IND,1529744050.0,1696597437.0,90878,1428329399,1583732070,16414,-74464,-81.93842294064571
107,57 ST-7 AV BMT,67805844684.0,55155405244.0,199223,3092458026,1388246812,40681,-158542,-79.5801689563956
108,59 ST BMT,2380002375.0,1280682238.0,142482,3277773148,1899906422,59000,-83482,-58.59126065046812
109,59 ST COLUMBUS IND,86959756106.0,70427184891.0,342395,85712541947,69476516693,80621,-261774,-76.4538033557733
110,59 ST COLUMBUS IRT,43615549821.0,50931619214.0,82875,41550385507,48498087377,16498,-66377,-80.09291101055807
111,59 ST IRT,52148589731.0,35135422013.0,219081,52377951238,34928246870,65526,-153555,-70.09051446725184
112,6 AV BMT,667835779.0,524082604.0,14170,13909190218,8271211262,3496,-10674,-75.32815808045166
113,61 ST WOODSIDE IRT,2422357638.0,2012259750.0,93090,2303731467,1794679037,37277,-55813,-59.95595660113868
114,63 DR-REGO PARK IND,2519012957.0,869809794.0,94003,2456148828,861994361,33651,-60352,-64.20220631256448
115,65 ST IND,993726763.0,611973406.0,21240,939400402,565262088,8168,-13072,-61.54425612052731
116,66 ST-LINCOLN IRT,3142101644.0,2406330513.0,134384,2687556994,2124398753,20090,-114294,-85.05030360757233
117,67 AV IND,2042001342.0,1297540595.0,54459,2038543875,1283085783,16094,-38365,-70.44749260911878
118,68ST-HUNTER CO IRT,3180370889.0,2598387685.0,143686,2828629889,2363655036,36509,-107177,-74.59112230836685
119,69 ST IRT,1277472780.0,1073289642.0,30970,1138180625,977623697,13536,-17434,-56.29318695511786
120,7 AV BMT,959988286.0,953646742.0,50353,1474008729,1490130468,14261,-36092,-71.67795364725042
121,7 AV IND,2198114650.0,2491618027.0,178821,1797325521,2045391784,36528,-142293,-79.57286895834382
122,71 ST BMT,1147770454.0,654531963.0,33441,1088926568,639957957,9176,-24265,-72.56062916778805
123,72 ST IND,996043449.0,784317115.0,48775,636035022,480714142,12714,-36061,-73.93336750384418
124,72 ST IRT,2936773635.0,1607530955.0,228412,3030461188,1720878733,65587,-162825,-71.285659247325
125,72 ST-2 AVE IND,2616370602.0,986790926.0,183365,1748781460,1064127640,57078,-126287,-68.87192212254247
126,74 ST-BROADWAY IRT,660057330.0,659477574.0,20258,678942270,625291294,8546,-11712,-57.81419686049956
127,75 AV IND,20315712285.0,41978178049.0,21179,18992221448,39045224698,6605,-14574,-68.81344728268569
128,75 ST-ELDERTS BMT,371853722.0,327507365.0,16442,286232692,279610964,9737,-6705,-40.779710497506386
129,77 ST BMT,1324255243.0,751640979.0,34688,1333804230,754320263,12010,-22678,-65.37707564575645
130,77 ST IRT,10813511740.0,4489659333.0,144761,4969692716,3806069447,53483,-91278,-63.05427566817029
131,79 ST BMT,4013898498.0,5309564141.0,39518,1242821923,585419209,11241,-28277,-71.55473455134369
132,79 ST IRT,1614395946.0,483555093.0,86390,23201575882,23003798096,24813,-61577,-71.27792568584327
133,8 AV BMT,6284589023.0,3051092351.0,207402,5905747879,2739355035,56412,-150990,-72.80064801689473
134,8 ST-NYU BMT,4809942043.0,2488247949.0,103151,4184032179,1439984413,22433,-80718,-78.25227094259871
135,80 ST IND,995239001.0,394078597.0,25702,702952391,363968472,8883,-16819,-65.43848727725468
136,81 ST-MUSEUM IND,1826985986.0,1400673518.0,72366,4040636160,1828146268,17085,-55281,-76.39084653013846
137,82 ST-JACKSON H IRT,1533591966.0,1094293699.0,94814,1555853271,928460521,43560,-51254,-54.0574176809332
138,85 ST-FOREST PK BMT,885053753.0,712396189.0,23318,939561461,751556318,10058,-13260,-56.865940475169396
139,86 ST BMT,6902019981.0,3550358512.0,84948,2104789872,1503564034,34769,-50179,-59.07025474407873
140,86 ST IND,1176146433.0,618132428.0,64035,1082167034,531099499,17992,-46043,-71.90286562036387
141,86 ST IRT,50417560089.0,89720889332.0,357358,50212228468,89879609875,111682,-245676,-68.7478662853497
142,86 ST-2 AVE IND,1224122120.0,995663610.0,155713,988369547,746141035,39460,-116253,-74.65850635463963
143,88 ST IND,238287843.0,73812572.0,17156,220484064,70682842,6454,-10702,-62.38050827698765
144,9 AV BMT,1233982846.0,1241321162.0,34790,1122096567,1135684794,10879,-23911,-68.72951997700488
145,90 ST-ELMHURST IRT,2759560825.0,1408554088.0,101699,2833105750,1454180166,58415,-43284,-42.56089047089942
146,96 ST IND,1241502600.0,1091572037.0,59489,1299447161,1154559553,19059,-40430,-67.9621442619644
147,96 ST IRT,32397376855.0,5774849735.0,312950,34828052332,5562827533,101477,-211473,-67.57405336315705
148,96 ST-2 AVE IND,762902134.0,561182900.0,116041,663060828,530123709,34079,-81962,-70.63193181720254
149,9TH STREET PTH,11691730.0,12617755.0,43082,9071697,11699891,7346,-35736,-82.94879532055151
150,ALABAMA AV BMT,344804950.0,373100000.0,13389,350633596,384394523,6451,-6938,-51.81865710658003
151,ALLERTON AV IRT,923519437.0,85494927.0,32530,905236340,97095957,12406,-20124,-61.862895788502925
152,AQUEDUCT N.COND IND,249169003.0,885489662.0,5313,250735352,200807013,1932,-3381,-63.63636363636363
153,AQUEDUCT RACETR IND,2257326920.0,710376571.0,9463,2104345177,659723162,3885,-5578,-58.94536616295044
154,ASTOR PL IRT,980890013.0,1397845657.0,96818,799312343,1180325489,18002,-78816,-81.40635005887334
155,ASTORIA BLVD BMT,1913208741.0,1312381000.0,50103,1265183533,1189815233,21296,-28807,-57.4955591481548
156,ASTORIA DITMARS BMT,1517957863.0,1214338357.0,103094,1574734846,1279834386,29956,-73138,-70.9430228723301
157,ATL AV-BARCLAY BMT,7089086102.0,1473682048.0,94196,3163973980,1268157173,25452,-68744,-72.97974436281795
158,ATL AV-BARCLAY IRT,3421681791.0,4122560689.0,195447,3274607332,3931923017,63071,-132376,-67.72987050197752
159,ATLANTIC AV BMT,158999583.0,66227290.0,10114,118400259,50404976,3727,-6387,-63.150088985564565
160,AVENUE H BMT,111446266.0,57099860.0,27127,94115447,55592963,8679,-18448,-68.00604563718804
161,AVENUE I IND,419631946.0,41219997309.0,13624,264769376,27122129106,4453,-9171,-67.31503229594833
162,AVENUE J BMT,706910980.0,440521581.0,34930,969774302,615253087,25350,-9580,-27.426281133695962
163,AVENUE M BMT,447168331.0,179520935.0,30729,520910829,162037226,14223,-16506,-53.71473201210583
164,AVENUE N IND,48805974741.0,409020889.0,19897,32158091372,268645356,6371,-13526,-67.980097502136
165,AVENUE P IND,583016680.0,350337967.0,16445,404722619,242025026,5439,-11006,-66.92611736089998
166,AVENUE U BMT,1739861810.0,1283566306.0,63889,1475980202,1226271231,29461,-34428,-53.88721063093803
167,AVENUE U IND,5924638588.0,394833865.0,12888,2653439321,275750336,3875,-9013,-69.93327126008691
168,AVENUE X IND,135316802.0,336908715.0,25302,107734303,251670545,5579,-19723,-77.95035965536321
169,B'WAY-LAFAYETTE IND,2346375972.0,2956361681.0,134388,2012073078,2869469178,25732,-108656,-80.85245706461886
170,BAY 50 ST BMT,540689758.0,370579576.0,17020,522689261,362074549,4914,-12106,-71.12808460634548
171,BAY PKWY BMT,3606084283.0,2508062865.0,82986,2819505328,2613711468,32252,-50734,-61.13561323596751
172,BAY PKWY IND,201037986.0,67207064.0,13077,133656164,44775217,2908,-10169,-77.76248375009558
173,BAY RIDGE AV BMT,1099279879.0,613604712.0,58322,63230124958,31336658885,17827,-40495,-69.43348993518741
174,BAY RIDGE-95 ST BMT,7345821159.0,898856974.0,35916,7392888336,937351555,12694,-23222,-64.65642053680811
175,BAYCHESTER AV IRT,61963798506.0,5051247316.0,21015,82629583532,6739068590,7048,-13967,-66.46205091601237
176,BEACH 105 ST IND,50514454.0,69348601.0,1382,42421487,57553257,392,-990,-71.63531114327061
177,BEACH 25 ST IND,26537012777.0,39776136379.0,10885,100396647,74675066,3577,-7308,-67.13826366559485
178,BEACH 36 ST IND,63927152.0,89488086.0,6127,60087129,83279080,2117,-4010,-65.4480169740493
179,BEACH 44 ST IND,102085246.0,89224714.0,4398,96060824,85111806,1644,-2754,-62.61937244201909
180,BEACH 60 ST IND,344937059.0,306816219.0,12350,35068267,7148084,4402,-7948,-64.35627530364373
181,BEACH 67 ST IND,513272562.0,482739814.0,13704,490985200,462939103,4823,-8881,-64.80589608873322
182,BEACH 90 ST IND,249603407.0,270190241.0,4618,220138337,240080314,3820,-798,-17.280207882200084
183,BEACH 98 ST IND,196962577.0,209250228.0,2838,182104467,194564032,883,-1955,-68.88653981677237
184,BEDFORD AV BMT,3147139678.0,2549185359.0,150395,3727956726,3408724180,40443,-109952,-73.10881345789421
185,BEDFORD PK BLVD IND,480843358.0,310794742.0,45231,358765708,271676017,16541,-28690,-63.42994848665738
186,BEDFORD PK BLVD IRT,132901354.0,53400153.0,36273,154603935,79656445,11382,-24891,-68.62128856174013
187,BEDFORD-NOSTRAN IND,4982368835.0,967299234.0,54980,5019159031,998585138,15387,-39593,-72.01345943979629
188,BERGEN ST IND,1130541025.0,911085169.0,73662,1104292863,842962348,16530,-57132,-77.55966441313025
189,BERGEN ST IRT,609050705.0,555169801.0,28741,580493819,510702695,5786,-22955,-79.86848056782992
190,BEVERLEY ROAD BMT,381546400.0,420106238.0,17159,490277419,577123902,7541,-9618,-56.052217495192025
191,BEVERLY RD IRT,3474002047.0,764457253.0,27315,3276529892,716001613,10392,-16923,-61.95496979681494
192,BLEECKER ST IRT,1200522473.0,503527515.0,90520,1564012619,591396440,20241,-70279,-77.63919575784357
193,BOROUGH HALL BMT,3105690268.0,73699103.0,13369,3217837207,81778634,3909,-9460,-70.76071508714189
194,BOROUGH HALL IRT,2969536806.0,1326784100.0,188392,2802134958,1291711311,40953,-147439,-78.26181578835619
195,BOTANIC GARDEN BMT,245086347.0,134918341.0,8933,223483329,122915208,2135,-6798,-76.09985447218179
196,BOWERY BMT,722008331.0,711005243.0,24465,542221869,485023655,5546,-18919,-77.33088085019415
197,BOWLING GREEN IRT,48999571156.0,56730625782.0,162505,30548774548,44383741017,30391,-132114,-81.29842158702809
198,BRIARWOOD IND,938661735.0,486177593.0,30793,781755154,465401143,10418,-20375,-66.16763550157503
199,BRIGHTON BEACH BMT,3124969564.0,2416194972.0,64240,3209505291,2712718694,28738,-35502,-55.26463262764633
200,BROAD CHANNEL IND,58187471.0,8998244.0,1810,53554511,8601620,606,-1204,-66.51933701657458
201,BROAD ST BMT,504981247.0,303214804.0,46378,462909672,252119255,8143,-38235,-82.44210617102937
202,BROADWAY BMT,2742757085.0,1330718594.0,73032,1001733664,1214206085,21970,-51062,-69.91729652754957
203,BROADWAY IND,847543043.0,645463534.0,32108,853533529,655732834,11971,-20137,-62.716456957767534
204,BROADWAY JCT IND,2645470399.0,2486774224.0,50814,1861792290,1846221075,25794,-25020,-49.238398866454126
205,BRONX PARK EAST IRT,40785571502.0,17998614134.0,15458,35836804372,15818040085,5793,-9665,-62.52425928321904
206,BROOK AV IRT,1001865609.0,667959187.0,36649,1004884475,691842021,17298,-19351,-52.80089497667058
207,BROOKLYN BRIDGE IRT,20653917537.0,27506087193.0,107484,19841611793,26877018296,20020,-87464,-81.37397194000967
208,BUHRE AV IRT,358299375.0,256329783.0,23005,344157198,251367857,8547,-14458,-62.84720712888503
209,BURKE AV IRT,427284507.0,166541603.0,20493,420687548,167003250,8034,-12459,-60.79636949202166
210,BURNSIDE AV IRT,25011392127.0,41409133512.0,63212,25052111878,41428928730,24822,-38390,-60.732139467189775
211,BUSHWICK AV BMT,293880854.0,248601381.0,12495,302576881,256573206,5253,-7242,-57.95918367346938
212,CANAL ST BMT,54082566874.0,122951086573.0,232583,52747283337,123212602133,59406,-173177,-74.4581504237197
213,CANAL ST IND,39459570343.0,24670283749.0,116574,39442471716,24547989120,23460,-93114,-79.87544392403109
214,CANAL ST IRT,557796515.0,534058163.0,34920,500967575,457661955,5894,-29026,-83.12142038946163
215,CANARSIE-ROCKAW BMT,1670791372.0,26487420.0,72498,2295949299,463404771,15637,-56861,-78.43112913459682
216,CARROLL ST IND,8124154023.0,1196151307.0,73492,101902533407,70788930951,19933,-53559,-72.87731998040603
217,CASTLE HILL AV IRT,1013113659.0,944832698.0,40085,1094421389,1031445623,15807,-24278,-60.56629661968317
218,CATHEDRAL PKWY IND,3742588856.0,6103388220.0,44902,3492773429,5919174541,13500,-31402,-69.93452407465146
219,CATHEDRAL PKWY IRT,894108916.0,550068208.0,70314,233757898,376576489,19781,-50533,-71.86762237961146
220,CENTRAL AV BMT,340100422.0,360317430.0,31895,315600502,329495434,7114,-24781,-77.69556356795736
221,CENTRAL PK N110 IRT,15101093080.0,10729762086.0,51383,14887260437,10566931162,15833,-35550,-69.18630675515249
222,CHAMBERS ST BMT,1329505698.0,1033994121.0,72350,1224694071,993322167,12094,-60256,-83.28403593642018
223,CHAMBERS ST IND,71388774612.0,33070382216.0,162750,59500322850,25495802601,27144,-135606,-83.32165898617512
224,CHAMBERS ST IRT,87646251474.0,71295704228.0,119241,89154616639,72290943709,18333,-100908,-84.6252547362065
225,CHAUNCEY ST BMT,287100755.0,109509157.0,21012,296249809,112311188,7534,-13478,-64.14429849609746
226,CHRISTOPHER ST IRT,1760101714.0,938855925.0,58952,1614468281,865089658,12262,-46690,-79.20002714072466
227,CHRISTOPHER ST PTH,44099288.0,45715371.0,31808,48702113,49391618,12116,-19692,-61.908953722334005
228,CHURCH AV BMT,2627944820.0,2769199389.0,79710,3535867042,3715284923,36780,-42930,-53.857734286789615
229,CHURCH AV IND,7232299238.0,1884559554.0,62563,7064867400,1563244033,25111,-37452,-59.862858238895186
230,CHURCH AV IRT,38647029150.0,66674004682.0,60102,36227805923,63326137628,23714,-36388,-60.54374230474859
231,CITY / BUS PTH,123286065.0,122379862.0,126929,137711429,106821008,41767,-85162,-67.09420227056071
232,CITY HALL BMT,9169078978.0,909761140.0,32680,6898192993,571729881,12914,-19766,-60.48347613219094
233,CLARK ST IRT,1183167193.0,1121841467.0,35028,1125808935,1069014482,7515,-27513,-78.54573484069887
234,CLASSON AV IND,2085313201.0,552622729.0,35623,1994138224,574035431,9974,-25649,-72.00123515706144
235,CLEVELAND ST BMT,430093610.0,429569648.0,18529,422990563,428805783,7316,-11213,-60.51594797344703
236,CLINTON-WASH AV IND,7191250693.0,2991801225.0,80391,7150886449,2931468909,20626,-59765,-74.34289908074288
237,CONEY IS-STILLW BMT,27188990481.0,13863884684.0,67486,27180524574,13886609409,31862,-35624,-52.787244761876536
238,CORTELYOU RD BMT,316747166.0,116849089.0,32207,424836722,156866649,14151,-18056,-56.0623466948179
239,CORTLANDT ST BMT,22972253298.0,22558423488.0,97567,34374350819,33922307575,16917,-80650,-82.66114567425461
240,COURT SQ IND,21452399907.0,23745778877.0,57800,25526355396,23674667740,12715,-45085,-78.00173010380624
241,COURT SQ IRT,1043629303.0,793871379.0,30783,815561885,640650920,7405,-23378,-75.94451482961375
242,COURT SQ-23 ST IND,206648227.0,68597194.0,35936,222782658,77317730,10746,-25190,-70.09683882457702
243,CRESCENT ST BMT,784868699.0,723049963.0,27977,308662778,391767934,11603,-16374,-58.526646888515565
244,CROWN HTS-UTICA IRT,9670747888.0,3933885607.0,154123,9505606538,3984798880,63485,-90638,-58.80887343225864
245,CYPRESS AV IRT,7260391114.0,9463215130.0,20483,7260250495,9472316625,8703,-11780,-57.511106771469024
246,CYPRESS HILLS BMT,305136428.0,181826880.0,9401,307489232,184501245,4119,-5282,-56.18551217955536
247,DEKALB AV BMT,60477956669.0,48131202129.0,173623,59471772325,47761053901,53767,-119856,-69.03232866613294
248,DELANCEY/ESSEX BMT,1543221900.0,1262129301.0,59878,1432967826,1193031286,17191,-42687,-71.28995624436354
249,DELANCEY/ESSEX IND,1689564106.0,1507118260.0,115541,1621604526,1522698861,29950,-85591,-74.07846565288513
250,DITMAS AV IND,3228490859.0,366201581.0,26646,321475043,251239682,9371,-17275,-64.83149440816632
251,DYCKMAN ST IND,1352274935.0,36533367.0,48832,1365828500,37743351,16907,-31925,-65.3772116644823
252,DYCKMAN ST IRT,259363190.0,140969099.0,32848,353574170,201746792,14269,-18579,-56.56052118850463
253,E 143/ST MARY'S IRT,233168671.0,248201258.0,7080,216963737,235120666,2936,-4144,-58.53107344632769
254,E 149 ST IRT,622469463.0,611422466.0,32551,630706709,630384821,13225,-19326,-59.371447881785514
255,E 180 ST IRT,1398104880.0,1088535580.0,48449,808116329,661450912,18241,-30208,-62.35010010526533
256,EAST 105 ST BMT,1019205099.0,944482807.0,19163,699928972,653502104,6546,-12617,-65.84042164588007
257,EAST BROADWAY IND,6856890079.0,2065982642.0,85174,3742635247,1210806458,19233,-65941,-77.41916547303168
258,EASTCHSTER/DYRE IRT,17638721948.0,17709670883.0,22360,21553250368,21649518012,10194,-12166,-54.409660107334524
259,EASTN PKWY-MUSM IRT,778269809.0,1084544925.0,25986,7477908526,1745702796,9551,-16435,-63.24559378126684
260,ELDER AV IRT,518688341.0,493460233.0,40468,515421944,462874304,17679,-22789,-56.31363052288228
261,ELMHURST AV IND,64310226890.0,180062313879.0,63963,12515745951,93338474520,29684,-34279,-53.59192032894017
262,EUCLID AV IND,813495591.0,314119445.0,62532,841913275,330933863,24702,-37830,-60.497025522932255
263,EXCHANGE PLACE PTH,113979675.0,93514289.0,94391,103292427,84679835,13995,-80396,-85.17337458020361
264,FAR ROCKAWAY IND,155629435.0,214229352.0,27463,157200388,208645642,10701,-16762,-61.034846884899686
265,FLATBUSH AV-B.C IRT,58264819592.0,34053687915.0,125135,48477464465,28312170223,40203,-84932,-67.8722979182483
266,FLUSHING AV BMT,1897684866.0,1172078257.0,56565,1926122914,1179403538,21276,-35289,-62.38663484486874
267,FLUSHING AV IND,360696526.0,359704822.0,15025,414638524,413816209,8504,-6521,-43.40099833610649
268,FLUSHING-MAIN IRT,6675393021.0,6263272019.0,276777,4682063235,5858131562,130018,-146759,-53.02427586107227
269,FORDHAM RD IND,1164677795.0,450481405.0,76278,1050999770,443691278,27044,-49234,-64.545478381709
270,FORDHAM RD IRT,72582103698.0,15447708362.0,58415,76210691514,16237068389,28505,-29910,-51.20260207138577
271,FOREST AVE BMT,461444561.0,471233715.0,28229,453124149,460254244,10086,-18143,-64.27078536257041
272,FOREST HILLS 71 IND,3627632347.0,2275630563.0,157802,3267710514,1831412613,52068,-105734,-67.0042204788279
273,FRANKLIN AV IND,710874102.0,1111267520.0,40026,619807513,824271495,11625,-28401,-70.95637835406986
274,FRANKLIN AV IRT,14341917732.0,6138386347.0,77684,14378614395,6167772469,16356,-61328,-78.94547139694146
275,FRANKLIN ST IRT,1124041062.0,356051979.0,32162,1037485754,318677743,5621,-26541,-82.52285305640197
276,FREEMAN ST IRT,7418066568.0,1076935168.0,28091,6570795042,996002909,10944,-17147,-61.04090278024991
277,FRESH POND RD BMT,1119075000.0,585403634.0,38501,1008438331,538172562,14014,-24487,-63.60094542998883
278,FT HAMILTON PKY BMT,951027707.0,783176129.0,64036,916632204,736548294,24746,-39290,-61.356112186894876
279,FT HAMILTON PKY IND,632482946.0,242141185.0,38294,552262074,209572886,9276,-29018,-75.77688410717084
280,FULTON ST BMT,125559329163.0,82705430049.0,41263,58241449441,51132631171,5956,-35307,-85.56576109347357
281,FULTON ST IND,29030587763.0,26394766431.0,366124,26001725554,23513574496,83455,-282669,-77.20581005342451
282,FULTON ST IRT,11131600338.0,8194001635.0,147788,1583572470,1896001948,30085,-117703,-79.64313746718273
283,GATES AV BMT,390977337.0,143775972.0,44966,273819931,99798471,14523,-30443,-67.70226393274919
284,GRAHAM AV BMT,1751812128.0,978407775.0,53826,1705831745,987992127,16322,-37504,-69.67636458217218
285,GRAND ARMY PLAZ IRT,1276203712.0,657123319.0,50623,794840434,364902488,11477,-39146,-77.3284870513403
286,GRAND ST BMT,842943524.0,729126862.0,37993,867679124,756229748,14011,-23982,-63.122154081014926
287,GRAND ST IND,12521800290.0,60025835321.0,149654,2778552069,2439111232,46104,-103550,-69.19293837785825
288,GRAND-NEWTOWN IND,1229335521.0,1136581653.0,97278,1247354212,1059653715,41494,-55784,-57.344928966467236
289,GRANT AV IND,50469228888.0,72953918566.0,35210,50476630914,72968667213,12932,-22278,-63.27179778472025
290,GRD CNTRL-42 ST IRT,24205486988.0,70036277243.0,778488,20682010431,67535080545,148940,-629548,-80.8680416396913
291,GREENPOINT AV IND,853615024.0,584606998.0,63799,886277249,617779305,21393,-42406,-66.46812645966239
292,GROVE STREET PTH,158150879.0,164990475.0,131493,148917580,162592759,32471,-99022,-75.30590982029462
293,GUN HILL RD IRT,82794039310.0,72453029381.0,58433,84467697935,73694656182,27792,-30641,-52.437834785138534
294,HALSEY ST BMT,5345370601.0,2754752912.0,85221,4802248735,2427154047,28792,-56429,-66.2149000833128
295,HARLEM 148 ST IRT,495420201.0,392666423.0,23978,507095448,404427494,7875,-16103,-67.15739427808825
296,HARRISON PTH,59934804.0,44544169.0,83585,71697629,49750672,39110,-44475,-53.20930789017169
297,HEWES ST BMT,530717373.0,238034214.0,22810,511313797,219408809,6642,-16168,-70.8811924594476
298,HIGH ST IND,111007749120.0,150010974908.0,62227,79041579364,73732755967,13468,-48759,-78.35666189917559
299,HOUSTON ST IRT,1519447756.0,1598290319.0,83812,1458789664,1409927363,14032,-69780,-83.25776738414547
300,HOWARD BCH JFK IND,224116849.0,110124647.0,26912,314231988,92259812,7175,-19737,-73.3390309155767
301,HOYT ST IRT,952262715.0,852844939.0,49291,1119815804,791965618,13523,-35768,-72.5649712929338
302,HOYT-SCHER IND,1819553959.0,1764173690.0,73083,1877027782,1826062731,20544,-52539,-71.88949550511062
303,HUNTERS PT AV IRT,24983928965.0,25015312097.0,39681,15233382730,15298947060,8900,-30781,-77.57112975983468
304,HUNTS POINT AV IRT,2992349542.0,2024150889.0,59768,28263686762,38974995339,23627,-36141,-60.46881274260474
305,INTERVALE AV IRT,490099850.0,449860116.0,19941,494613025,460538070,8137,-11804,-59.19462414121659
306,INWOOD-207 ST IND,9348603135.0,543093494.0,70193,8982409585,568213550,24672,-45521,-64.85119598820394
307,JACKSON AV IRT,134717250545.0,11575528610.0,33854,126534261491,10877200868,11434,-22420,-66.22555680274118
308,JAMAICA 179 ST IND,4247814567.0,2524192503.0,123598,4032169670,2395138355,46670,-76928,-62.24048932830628
309,JAMAICA CENTER IND,5892109964.0,3877345374.0,203674,3890847763,2675043406,78201,-125473,-61.60481946640219
310,JAMAICA VAN WK IND,834708829.0,807868914.0,26075,424190351,263761398,11619,-14456,-55.440076701821674
311,JAY ST-METROTEC BMT,7975349709.0,23953262401.0,21470,9866697388,30509828592,4818,-16652,-77.5593851886353
312,JAY ST-METROTEC IND,54349684424.0,59178698647.0,228230,3321681687,1992618674,48483,-179747,-78.75695570258074
313,JEFFERSON ST BMT,827661856.0,362325806.0,44840,493463038,275100026,14211,-30629,-68.30731489741304
314,JFK JAMAICA CT1 IND,96840177.0,69633285.0,60133,46135626,40464396,8840,-51293,-85.29925332180333
315,JKSN HT-ROOSVLT IND,4747200156.0,3908541537.0,298671,3427022211,2562416070,121439,-177232,-59.340210465696366
316,JOURNAL SQUARE PTH,144883156.0,69710832.0,170774,179774874,103462374,77253,-93521,-54.763020131870185
317,JUNCTION BLVD IRT,2714898074.0,3231504576.0,132522,2582886762,3095508923,70659,-61863,-46.68130574546113
318,JUNIUS ST IRT,620504364.0,430503181.0,14517,627648515,445635923,5226,-9291,-64.00082661706963
319,KEW GARDENS IND,4848944866.0,4209622859.0,146719,4831248310,4225525631,52650,-94069,-64.11507712020938
320,KINGS HWY BMT,39334895808.0,24813619445.0,143469,35191388279,21362801164,61989,-81480,-56.792756623382054
321,KINGS HWY IND,4516541161.0,149737988.0,25454,2581422999,101874152,7585,-17869,-70.2011471674393
322,KINGSBRIDGE RD IND,74387863837.0,91480557999.0,52107,45482233327,48341779358,17747,-34360,-65.94123630222427
323,KINGSBRIDGE RD IRT,1556077075.0,709252943.0,54562,1598120438,744037562,22842,-31720,-58.13569883801913
324,KINGSTON AV IRT,1465537301.0,1252385144.0,29886,1484725119,1274552718,10572,-19314,-64.62557719333468
325,KINGSTON-THROOP IND,556520943.0,564822469.0,42166,475222387,357784068,11185,-30981,-73.47388891523977
326,KNICKERBOCKER BMT,524102190.0,493661072.0,32888,481535667,454071361,9279,-23609,-71.78606178545365
327,KOSCIUSZKO ST BMT,617740070.0,300318202.0,34940,618049058,305833211,11110,-23830,-68.20263308528907
328,LACKAWANNA PTH,61423893.0,51695090.0,93287,46838552,36696267,30192,-63095,-67.63536184034217
329,LAFAYETTE AV IND,618153595.0,437891790.0,24261,763336809,327358139,7127,-17134,-70.62363463995713
330,LEXINGTON AV/53 IND,98553185414.0,75913771677.0,217663,89926537142,68910643517,44700,-172963,-79.46366630984596
331,LEXINGTON AV/63 IND,1543014425.0,1631159634.0,117682,1603256928,1691605769,32991,-84691,-71.96597610509679
332,LIBERTY AV IND,582420515.0,323694784.0,17262,304648788,114202607,6548,-10714,-62.066967906383965
333,LIVONIA AV BMT,312265201.0,115536089.0,19136,206478024,71184353,5784,-13352,-69.7742474916388
334,LONGWOOD AV IRT,30375342640.0,40920053107.0,8522,29056427115,38769955773,8605,83,0.9739497770476413
335,LORIMER ST BMT,1107618801.0,459360518.0,66961,1067036581,457687019,18173,-48788,-72.86032167978375
336,MARBLE HILL-225 IRT,327373911.0,41010277.0,27066,344408973,46803090,10824,-16242,-60.00886721347817
337,MARCY AV BMT,1952178150.0,426041204.0,94459,1375161989,399210418,24086,-70373,-74.50110630008787
338,METROPOLITAN AV BMT,872260659.0,479107971.0,18523,429199358,492823968,8156,-10367,-55.968255682124926
339,METROPOLITAN AV IND,1146637279.0,840285853.0,59729,1155154442,838011990,20592,-39137,-65.524284685831
340,METS-WILLETS PT IRT,96612755.0,50429700.0,12137,32223434255,8346344216,6478,-5659,-46.62601960945868
341,MIDDLETOWN RD IRT,486834291.0,352371230.0,12132,479551131,355422666,4084,-8048,-66.33696010550611
342,MONTROSE AV BMT,6115489539.0,468559101.0,39894,6140641935,493313531,13528,-26366,-66.09013886800021
343,MORGAN AV BMT,335333130.0,151716022.0,42168,136475834,48161659,12485,-29683,-70.39224056156327
344,MORISN AV/SNDVW IRT,315370890.0,333939031.0,39232,343616241,371245249,16060,-23172,-59.06402936378466
345,MORRIS PARK IRT,265014158.0,189327230.0,13332,358167716,250125626,5419,-7913,-59.35343534353436
346,MOSHOLU PKWY IRT,1851426413.0,1288812480.0,47792,1797033402,1228701424,22087,-25705,-53.78515232674924
347,MT EDEN AV IRT,511702618.0,362077377.0,30703,539439014,387270887,13863,-16840,-54.848060450118886
348,MYRTLE AV BMT,1850015111.0,1478053298.0,77733,1895485354,1520668682,22576,-55157,-70.95699381215186
349,MYRTLE-WILLOUGH IND,1126083848.0,692959567.0,37680,421594209,477412613,12100,-25580,-67.88747346072186
350,MYRTLE-WYCKOFF BMT,70791761317.0,24572696724.0,115259,70810093965,24636063838,47285,-67974,-58.975004121153226
351,NASSAU AV IND,593481277.0,486457092.0,64110,569818723,470535145,17946,-46164,-72.00748713149274
352,NECK RD BMT,423664957.0,68280415.0,26495,435011953,72755477,9858,-16637,-62.792979807510854
353,NEPTUNE AV IND,342865148.0,133679594.0,9788,236140409,96149967,3296,-6492,-66.32611360850021
354,NEREID AV IRT,619713778.0,252806613.0,20653,408827091,96313305,8714,-11939,-57.807582433544766
355,NEVINS ST IRT,1014369967.0,1262266877.0,63107,604895759,528683555,17486,-45621,-72.29150490436878
356,NEW LOTS AV IRT,1615952797.0,1118801104.0,33436,1645667777,1156733772,14448,-18988,-56.789089604019615
357,NEW LOTS BMT,522649616.0,496911220.0,24591,4831830809,41194308727,8726,-15865,-64.51547314057989
358,NEW UTRECHT AV BMT,648232517.0,752087605.0,31285,611787409,744075431,25587,-5698,-18.213201214639604
359,NEWARK BM BW PTH,82470997.0,5374239.0,81986,95580223,6074491,33739,-48247,-58.84785207230503
360,NEWARK C PTH,33336837.0,4003617.0,48404,32016016,7663744,6747,-41657,-86.06106933311295
361,NEWARK HM HE PTH,1779760.0,33302705.0,20633,61434,2037980,18789,-1844,-8.937139533756604
362,NEWARK HW BMEBE PTH,23670628.0,14419317.0,53934,13953680,2511938,16798,-37136,-68.85452590202841
363,NEWKIRK AV IRT,1965454370.0,711232179.0,44913,1890657792,499313849,17728,-27185,-60.52813216663326
364,NEWKIRK PLAZA BMT,1432178621.0,1291974285.0,52616,4050098730,3654160783,23150,-29466,-56.00197658506918
365,NORTHERN BLVD IND,1047577334.0,945809633.0,40322,995028073,891830625,16381,-23941,-59.374534993303904
366,NORWOOD 205 ST IND,20444511339.0,12037866755.0,53971,13047256666,8073844124,20715,-33256,-61.618276481814306
367,NORWOOD AV BMT,554273183.0,602542387.0,19387,566492174,621483623,7835,-11552,-59.58632073038635
368,NOSTRAND AV IND,1702765457.0,1586121631.0,108129,1714128954,1652376887,35529,-72600,-67.14202480370668
369,NOSTRAND AV IRT,74258098.0,55968092.0,25934,89866381,76461295,8465,-17469,-67.35945091385825
370,OCEAN PKWY BMT,326876425.0,228423072.0,18026,365517323,271296492,7593,-10433,-57.877510262953514
371,OZONE PK LEFFRT IND,1261898621.0,1155301695.0,43849,1272771045,1164720054,18781,-25068,-57.16892061392505
372,PARK PLACE BMT,553331241.0,601102102.0,10029,564194092,615331202,3434,-6595,-65.75929803569647
373,PARK PLACE IRT,410855899.0,388675876.0,16400,237980971,216202677,2942,-13458,-82.0609756097561
374,PARKCHESTER IRT,7773960239.0,11857613104.0,90831,7899574706,11501915616,35222,-55609,-61.22249011901223
375,PARKSIDE AV BMT,1166711744.0,1013689386.0,28757,1736261853,1510961719,14493,-14264,-49.60183607469485
376,PARSONS BLVD IND,959046350.0,349569944.0,41358,985167924,363137017,17542,-23816,-57.584989602978865
377,PATH NEW WTC PTH,153394824.0,148410638.0,334961,189417842,165834015,95222,-239739,-71.57221288448507
378,PATH WTC 2 PTH,12243695.0,53762646.0,15480,11945609,25560389,13026,-2454,-15.852713178294572
379,PAVONIA/NEWPORT PTH,139351893.0,125017899.0,104912,56673678,107682349,18203,-86709,-82.64926795790758
380,PELHAM BAY PARK IRT,1881098233.0,894746019.0,43071,1464271873,926118247,16483,-26588,-61.73063081888045
381,PELHAM PKWY IRT,34957258197.0,10225809847.0,72549,32696538088,11776715277,26889,-45660,-62.93677376669561
382,PENNSYLVANIA AV IRT,317308721.0,124631294.0,27674,335749890,137229485,11531,-16143,-58.33273108332732
383,PRESIDENT ST IRT,701522419.0,791468219.0,24328,417586929,571409481,7401,-16927,-69.57826372903651
384,PRINCE ST BMT,3064979839.0,1971427042.0,71712,2967470440,1847432768,15321,-56391,-78.63537483266398
385,PROSPECT AV BMT,1070004690.0,1248650834.0,33457,1408279136,1309745836,11115,-22342,-66.77825268254774
386,PROSPECT AV IRT,1104884586.0,214064635.0,45723,3538840789,828345470,16714,-29009,-63.44509327909367
387,PROSPECT PARK BMT,66228105006.0,33977096967.0,56100,65927504830,33297394308,20331,-35769,-63.75935828877005
388,QUEENS PLAZA IND,3916238687.0,1982930871.0,87566,3403919785,1728371177,19001,-68565,-78.30093872050796
389,QUEENSBORO PLZ IRT,1436997146.0,433327451.0,92046,1413127854,433013125,26044,-66002,-71.70545162201508
390,RALPH AV IND,1178561358.0,842034916.0,35961,1186176539,850085826,12281,-23680,-65.84911431828925
391,RECTOR ST BMT,4225396796.0,933243391.0,34579,5020337811,1172357332,6875,-27704,-80.11799068798982
392,RECTOR ST IRT,1386371705.0,961158915.0,48760,913975000,488114902,8202,-40558,-83.17883511074652
393,RIT-MANHATTAN RIT,50585870.0,836555.0,22625,57962095,1197960,8672,-13953,-61.670718232044194
394,RIT-ROOSEVELT RIT,314989939.0,18739933.0,24157,168798850,2584998,10827,-13330,-55.1806929668419
395,ROCKAWAY AV IND,595438061.0,322480442.0,35876,597180606,335273319,12087,-23789,-66.30895306054187
396,ROCKAWAY AV IRT,135446886.0,187613386.0,29236,159892797,221377662,13051,-16185,-55.359830346148584
397,ROCKAWAY BLVD IND,6397459795.0,570553593.0,44829,6265223064,566125816,18634,-26195,-58.43315710812197
398,ROCKAWAY PARK B IND,219401237.0,482296060.0,3985,196646700,421563582,1655,-2330,-58.469259723964875
399,ROOSEVELT ISLND IND,700541673.0,610621205.0,45573,719294071,621588413,13793,-31780,-69.73427248590174
400,SARATOGA AV IRT,3693306892.0,1555695446.0,31554,3649210861,1567893385,13494,-18060,-57.2352158204982
401,SENECA AVE BMT,337039130.0,360191935.0,23293,327336710,351657109,6925,-16368,-70.27003820890397
402,SHEEPSHEAD BAY BMT,2147596428.0,2006291807.0,78776,2090830505,1942349534,30209,-48567,-61.65202599776581
403,SHEPHERD AV IND,379132624.0,405373110.0,19293,382664791,406636567,7256,-12037,-62.39050432799461
404,SIMPSON ST IRT,16510552416.0,12337290973.0,52483,15795904359,12071751925,21694,-30789,-58.66471047767848
405,SMITH-9 ST IND,543801622.0,511468660.0,28093,412023996,308904503,9632,-18461,-65.71387890221764
406,SOUTH FERRY IRT,6586427005.0,759406045.0,88652,6125338525,768497971,16626,-72026,-81.24576997698868
407,SPRING ST IND,14282480442.0,3599321277.0,80778,962035441,273081162,14992,-65786,-81.44049122285772
408,SPRING ST IRT,1409198696.0,1520619149.0,61323,1393505329,1426726478,13178,-48145,-78.51050992286744
409,ST LAWRENCE AV IRT,14682404856.0,4656147455.0,25643,41796622684,12806418891,11118,-14525,-56.643138478337164
410,ST. GEORGE SRT,50929575608.0,44216054001.0,70465,50021105087,43137623586,17540,-52925,-75.10820974952104
411,STEINWAY ST IND,2714365535.0,2018455730.0,87177,2767563709,2073214649,27936,-59241,-67.95485047661654
412,STERLING ST IRT,769930809.0,425115088.0,35633,793025963,444596061,12620,-23013,-64.5833917997362
413,SUTPHIN BLVD IND,4149303855.0,407719781.0,26644,3785516376,400505606,10563,-16081,-60.35505179402492
414,SUTPHIN-ARCHER IND,5618068268.0,3099401091.0,142786,5707650989,3203445504,51795,-90991,-63.72543526676285
415,SUTTER AV BMT,169092674.0,118191357.0,20291,62237628,71113435,6571,-13720,-67.61618451530235
416,SUTTER AV-RUTLD IRT,817345384.0,694403995.0,40700,835434143,645626184,16691,-24009,-58.990171990171994
417,THIRTY ST PTH,51994790.0,11753886.0,67083,50046488,12784604,19839,-47244,-70.42618845311033
418,THIRTY THIRD ST PTH,164275666.0,87686567.0,133370,187515171,106537447,29856,-103514,-77.61415610707056
419,TIMES SQ-42 ST BMT,1203209328.0,1780488186.0,86912,1230167653,1821514706,19367,-67545,-77.7165408689249
420,TIMES SQ-42 ST IRT,153613733115.0,93178552840.0,429618,146893314780,73200000780,80777,-348841,-81.19794794445298
421,TOMPKINSVILLE SRT,84505171.0,300251.0,3889,85043575,160675,1849,-2040,-52.455644124453585
422,TREMONT AV IND,9739435188.0,7484174824.0,59355,21772377412,10159162394,23485,-35870,-60.43298795383708
423,TWENTY THIRD ST PTH,30400713.0,77418857.0,58451,40019786,50391981,10639,-47812,-81.79842945373046
424,UNION ST BMT,1022427054.0,1095422881.0,41015,1180078184,1156570696,12638,-28377,-69.18688284773863
425,UTICA AV IND,6495963174.0,1806297369.0,98170,6214183028,1827832209,31957,-66213,-67.44728532138127
426,V.CORTLANDT PK IRT,26313230817.0,25767933746.0,39688,26345264896,25785620878,16469,-23219,-58.50382987300947
427,VAN SICLEN AV BMT,648818808.0,645047749.0,16345,517792152,527946919,7098,-9247,-56.57387580299786
428,VAN SICLEN AV IRT,654893661.0,488359317.0,16580,646080556,486077131,6738,-9842,-59.360675512665864
429,VAN SICLEN AVE IND,577439700.0,587340475.0,18032,572148580,583891356,6831,-11201,-62.11734693877551
430,VERNON-JACKSON IRT,1791692821.0,1389878050.0,95159,1593018889,1127898139,20371,-74788,-78.59267121344277
431,W 4 ST-WASH SQ IND,4346989710.0,3901465925.0,251816,4314942328,3990216927,50917,-200899,-79.78007751691712
432,W 8 ST-AQUARIUM BMT,545766773.0,541675073.0,14654,545132840,537100455,4898,-9756,-66.57567899549612
433,WAKEFIELD/241 IRT,928764720.0,966428388.0,29442,946692042,990563676,13692,-15750,-53.49500713266762
434,WALL ST IRT,12749125323.0,8422676427.0,247588,6242527090,3324485272,43929,-203659,-82.25721763574971
435,WEST FARMS SQ IRT,23491558753.0,5035779626.0,41239,21841429432,4739512314,15621,-25618,-62.12080797303523
436,WESTCHESTER SQ IRT,791884345.0,755601955.0,36586,800226656,770933255,14337,-22249,-60.812879243426444
437,WHITEHALL S-FRY BMT,7528644925.0,2104066110.0,85725,9758775135,3070976744,19580,-66145,-77.15952172645086
438,WHITLOCK AV IRT,311596860.0,277203192.0,11618,332917924,291781343,4951,-6667,-57.385092098467894
439,WILSON AV BMT,822621467.0,742415641.0,26691,841553625,763446870,9935,-16756,-62.77771533475703
440,WINTHROP ST IRT,1206487269.0,259366965.0,45502,1237033105,269709917,17059,-28443,-62.509340248780276
441,WOODHAVEN BLVD BMT,961649248.0,695731922.0,29777,632149446,479144198,12153,-17624,-59.186620546059046
442,WOODHAVEN BLVD IND,1251909595.0,1032907705.0,119862,1387271429,1157966476,45468,-74394,-62.0663763327827
443,WOODLAWN IRT,1316186792.0,504396839.0,40372,1348632330,519583071,18369,-22003,-54.50064401070048
444,WORLD TRADE CTR IND,65592221894.0,75576987633.0,98624,57348346417,66184422559,21316,-77308,-78.38659961064243
445,WTC-CORTLANDT IRT,30193416606.0,172142586.0,78541,30191811490,132092395,16380,-62161,-79.14465056467323
446,YORK ST IND,1865840360.0,1472239750.0,75724,742573014,234545058,11791,-63933,-84.42897892345887
447,ZEREGA AV IRT,101287952.0,60654036.0,15909,105047757,67584361,6132,-9777,-61.455779747312846
